############################
#          # #             #
########## # #             #
#          # ######  #######
# ######   #x              #
#      #   # ########### ###
#####  #   # #            ##
       #     #        ######
############################