#### #######################
#          # #             #
########## # #             #
#          # ######  #######
# ######   #x              #
#      #   # ########### ###
#####  #   # #            ##
#      #     #        ######
############################